/--\  /------\
|  |  |  /-\ |
|  L--+  | | |
|        | L-+
|        L---\
L------------+