/--\  /------\
|  |  |  /-\ |
|  \--/  | | |
|        | \-/
|        \---\
\------------/